10 10
S111010010
1000010000
0000101011
1000000000
0000000001
0000101000
0000000000
0100000010
0100001000
01010000E0


